....................
....................
.......~~~X~~.......
.......######.......
.F................F.
---...F.F.F.F....---
.......F.F.F.F......
......--------......
...--...........--..
F..F............F..F
~~~~............~~~~
####....~~......####
#1....~~##~~.......#
#~~~~~######~~~~~~~#
####################
