....................
....................
....................
.......F.F.F......~X
.......-----......##
.F.F..........---.##
.----.............##
.........FFF......##
.........---......##
..................##
....FFF.......~~~.##
....---.~:~~:~###~##
.1....~~############
~~~~~~##############
####################
